#######
#....b#
#.###.#
#.#...#
#...#.#
#.#.#.#
#....a#
#######