#####################
#.#...#######......b#
#.###.###.##.##.###.#
#.#...#...#.....#...#
#.#.#.#.###.###.#.#.#
#...#.#...#.#.#.#.#.#
#.###.#.#.#.#.#.#.#.#
#.#...#.#...#.#.#.#.#
#.#.###.###.#.#.#.#.#
#.#.....#...#.#.#.#.#
#.#########.###.#.###
#.........#.....#.#.#
#.#################.#
#.#..............#..#
#.#.###############.#
#.#.................#
#.#.#############.#.#
#.#..............#..#
#.#.###############.#
#a..................#
#####################
