#####################
#.#...#######......a#
#.###.###.##.##.###.#
#.#...#...#.....#...#
#.#.#.#.###.###.#.#.#
#...#.#...#.#.#.#.#.#
#.###.#.#.#.#.#.#.#.#
#.#...#.#...#.#.#.#.#
#.#.###.###.#.#.#.#.#
#.#.....#...#.#.#.#.#
#.#######.#.###.#.#.#
#.........#.....#.#.#
#.#################.#
#.#..............#..#
#.#.###############.#
#.#.................#
#.#.#############.#.#
#.#..............#..#
#.#.###############.#
#.b.................#
#####################
